ANA = "countries/Anarchist.txt" #
EYP = "countries/Eylstadt.txt" #埃尔施塔特
GIA = "countries/Giad.txt" #齐亚德
REG = "countries/Regicide.txt" #雷古戚德
SMA = "countries/San_Magnolia.txt" #圣玛格诺利亚
RGC = "countries/Roa_Gracia.txt" #罗亚·葛雷基亚
WAT = "countries/Walther.txt" #瓦尔特
TIA = "countries/Tiam.txt" #堤亚穆
TOR = "countries/Torlistine.txt" #托里斯汀
MUL = "countries/Mulunayit.txt" #穆露奈依特
ELF = "countries/Elfrieden.txt" #艾尔孚利登
SAV = "countries/Savoia.txt" #苏瓦尔
JRT = "countries/Jura_Tempest.txt" #鸠拉·特恩佩斯特
AGL = "countries/Aglaiarden.txt" #阿格莱阿登
BER = "countries/Berthence.txt" #贝尔特恩斯
ABN = "countries/Abanova.txt" #阿巴诺巴
AOT = "countries/Aort.txt" #奥尔特
EDE = "countries/Eden.txt" #伊甸之都
PLA = "countries/Planeptune.txt" #紫耀之都
LAS = "countries/Lastation.txt" #黑土边域
LOW = "countries/Lowee.txt" #白露之滨
LEA = "countries/Leanbox.txt" #绿荫箱庭
AIL = "countries/AIL.txt" #军团
Z86 = "countries/Z86.txt" #八六
CRB = "countries/Crossbell.txt" #克洛斯贝尔
NUB = "countries/Northumbria.txt" #诺森比亚
HBG = "countries/Hakurei_Great_Barrier.txt" #博丽大结界
GSK = "countries/Gensokyo.txt" #幻想乡
USS = "countries/Eagle.txt" #白鹰联合
HMS = "countries/Royal_Navy.txt" #皇家海军
IRN = "countries/Sakura_Island.txt" #重樱群岛
SMS = "countries/Iron_Blood.txt" #铁血帝国
ROC = "countries/Dragon.txt" #东煌民国
SNP = "countries/Northern_Parliament.txt" #北方联合
FNF = "countries/Iris_Liberty.txt" #自由鸢尾
MNF = "countries/Curia_Cichya.txt" #维希教廷
SRN = "countries/Sardinian.txt" #撒丁帝国
TMB = "countries/Tiam_Mulunayit_Buffer.txt" #堤亚穆-穆露奈依特军事缓冲区
PAT = "countries/Paretia.txt" #帕雷提亚
BET = "countries/Bertram.txt" #贝尔托姆
DKA = "countries/Demon_King_Army.txt" #魔王军
YBL = "countries/YBL.txt" #伊比利亚
ALC = "countries/Aluca.txt" #阿鲁卡
LAN = "countries/Landsol.txt"
WPE = "countries/White Pole.txt"
RAT = "countries/Ratatoskr.txt"
NEB = "countries/Nebulis.txt"
ACC = "countries/Academy City.txt"
RSL = "countries/Revue Starlight.txt"
ALN = "countries/Albion.txt"
BST = "countries/BST.txt" #不可思议之国
FON = "countries/Fontain.txt" #枫丹国
OLD = "countries/Overlord.txt"
UMA = "countries/Umamusume.txt"
CET = "countries/Camelot.txt"
WDM = "countries/Windermere.txt"
WGN = "countries/Willington.txt"
BEL = "countries/Belzec.txt" #贝尔泽古（妈的阿库娅）
TAR = "countries/Tara.txt"
KDE = "countries/Katzdale.txt"
MDK = "countries/Madoka_Principle.txt" #圆环之理
WSG = "countries/Warship Girls.txt"
HKR = "countries/Hakurei_Jinja.txt" #博丽神社
MYH = "countries/Mayohiga.txt" #迷途之家
HMN = "countries/Human_Village.txt" #人间之里
FOM = "countries/Forest_of_Magic.txt" #魔法之森
YKM = "countries/Youkai_Mountain.txt" #妖怪之山
SDM = "countries/Scarlet_Devil_Mansion.txt" #红魔馆
LNC = "countries/Lunar_Capital.txt" #月之城
UDW = "countries/Under_World.txt" #地底世界
SGY = "countries/Saigyouji.txt" #西行寺
RNA = "countries/Rinascita.txt"
VIA = "countries/Vinea.txt"
NRC = "countries/North Railway Committee.txt"
ALP = "countries/Assault Lily Project.txt"
CWS = "countries/Clockwork State.txt"
KPR = "countries/Knight Prester.txt"